. . . . . . . . . . . B B B . . . . . . . . . . E .
. . . . . . . . . . . B B B . . . . . . . . . . . .
. . . . . . . . . . . B B B . . . . . . . . . . . .
. . . . . . . . . . . B B B . . . . . . . . . . . .
. . . . . . . . . . . B B B . . . . . . . . . . . .
. . . . . . . . . . . B B B . . . . . . . . . . . .
. . . . . . . . . . . B B B . . . . . . . . . . . .
. . . . . . . . . . . B B B . . . . . . . . . . . .
. . . . . . . . . . . B B B . . . . . . . . . . . .
. . . . . . . . . . . B B B . . . . . . . . . . . .
B B B B B B B B B B B B B B B B B B B B B B B B B B
B B B B B B B B B B B B B B B B B B B B B B B B B B
B B B B B B B B B B B B B B B B B B B B B B B B B B
. . . . . . . . . . . . . . . . . . . . . . . . . .
. . . . . . . . . . . . . . . . . . . . . . . . . .
. . . . . . . . . . . . . . . . . . . . . . . . . .
. . . . . . . . . . . . . . . . . . . . . . . . . .
. . . . . . . . . . . . . . . . . . . . . . . . . .
. . . . . . . . . . . . . . . . . . . . . . . . . .
. . . . . . . . . . . . . . . . . . . . . . . . . .
. . . . . . . . . . . . . . . . . . . . . . . . . .
. . . . . . . . . . . . . . . . . . . . . . . . . .
. . . . . . . . . . . . . . . . . . . . . . . . . .
. . . . . . . . . . . B B B B . . . . . . . . . . .
. . . . . . . . . . . B A . B . . . . . . . . . . .
. . . . . . . . . . . B . . B . . . . . . . . . . .