. . . . . . . . . . . . . . . . . . B B B B B B B B
. . . . . . . . . . . . . . . . . . B B B B B B B B
. . . . . . . . . . . . . . . . . . B B B B B B B B
. . . . . . . . . . . . . . . . . . B B B B B B B B
. . . . . . . . . . . . . . . . E . B B B B B B B B
. . . . . . . . . . . . . . . . . . B B B B B B B B
. . . . . . . . E . C C . . . . . . B B B B B B B B
. . . . . . . . . . C C . . . . . . B B B B B B B B
. . . . . . E . . . C C . . . . . . B B B B B B B B
. . . . . . . . . . C C . . . . E . B B B B B B B B
. . . . E . . . . . . . . . . . . . B B B B B B B B
. . . . . . . . . . . . . . . . . . B B B B B B B B
. . . . . . E . . . . . . . . . . . . . . . . . . .
T T T T T T T T T T T T T T T T T T T T T T T T T T
T T T T T T T T T T T T T T T T T T T T T T T T T T
T T T T T T T T T T T T T T T T T T T T T T T T T T
T T T T T T T T T T T T T T T T T T T T T T T T T T
. . . . . . . . . . . . . . . . . . . . . . . . . .
. . E . . . E . . . . . . . . . . . . . . . . . E .
. . . . . . . . . . . . . I I I I I I I I . . . . .
. . . . . . . . . . . . . I I I I I I I I . . . . .
. W W W W W W W W . . . . I I I I I I I I . . . . .
. W W W W W W W W . . . . I I I I I I I I . . . W W
. . . . . . . . . . . . . I I I I I I I I . . . W W
. . . . . . . . . . . . . I I I I I I I I . . . E .
. B B B B B B B B . . . . . . . . . . . . . . . . .