. . . . . . . . . . . . . . . . . . B B B B B B B B
. . . . . . . . . . . . . . . . . . B B B B B B B B
. . . . . . . . . . . . . . . . . . B B B B B B B B
. . . . . . . . . . . . . . . . . . B B B B B B B B
. . . . . . . . . . . . . . . . . . B B B B B B B B
. . . . . . . . . . . . . . . . . . B B B B B B B B
. . . . . . . . . . C C . . . . . . B B B B B B B B
. . . . . . . . . . C C . . . . . . B B B B B B B B
. . . . . . . . . . C C . . . . . . B B B B B B B B
. . . . . . . . . . C C . . . . . . B B B B B B B B
. . . . . . . . . . . . . . . . . . B B B B B B B B
. . . . . . . . . . . . . . . . . . B B B B B B B B
. . . . . . . . . . . . . . . . . . . . . . . . . .
T T T T T T T T T T T T T T T T T T T T T T T T T T
T T T T T T T T T T T T T T T T T T T T T T T T T T
T T T T T T T T T T T T T T T T T T T T T T T T T T
T T T T T T T T T T T T T T T T T T T T T T T T T T
. . . . . . . . . . . . . . . . . . . . . . . . . .
. . . . . . . . . . . . . . . . . . . . . . . . . .
. . . . . . . . . . . . . I I I I I I I I . . . . .
. . . . . . . . . . . . . I I I I I I I I . . . . .
. W W W W W W W W . . . . I I I I I I I I . . . . .
. W W W W W W W W . . . . I I I I I I I I . . . W W
. . . . . . . . . . . . . I I I I I I I I . . . W W
. . . . . . . . . . . . . I I I I I I I I . . . E .
. B B B B B B B B . . . . . . . . . . . . . . . . .